25 25
.......###....######.####
######.....##......#.####
##.....###.##.######.####
##.###.###.#..######.####
##.#######...#...........
##......###..#.##########
####.###...###.##########
####.....#.###.##########
####.###.#.#........#####
####.###.#.#.######.#####
####.....#.#....###.#####
##########.####.###.#####
###......#.####.###.#####
###.####....#...###......
###.#########.#####.#####
###......####.#####.#####
###.####.####.#####.#####
###.####.####.#####.#####
###.####............#####
###.####.##.###.#########
###.........###.#########
###.######.####........##
###.######.######.####.##
###.######.######.####.##
....######.####...####...